 ##################################
 #############  ###################
 #############  ###################
 #############  ###################
 #############  ###################
 #############  ###################
 #              ###################
 #              ###################
 ##################################
 ##################################
 ##################             ###
 ##################            ####
 ##################  ##############
 ##################  ####$#########
 ##################  ##############
 ##################  ##############
 ##################################
                                        
